15 20
XXXXXXXXXXXXXXXXXXXX
X X X   X*  X X X  X
X X X X X*X X X O  X
X O X X*X X   O  **X
X X   X*X X*X X X**X
X X*X X*X X*O X X  X
X X*X X X X*X X X  X
X X X*O   X   X X GX
XS  X*X X X X X*X  X
X X O*X X X X X*X  X
X X*X*X X X O   X  X
X X*X   X X X X*X  X
X X*X O X*X*X X*X  X
X X*X X X***X X    X
XXXXXXXXXXXXXXXXXXXX
